0000000000000000000
0000000000000000000
0000000000000000000
0000000000000000000
2222222222222222222
1r1r1r1r1r1r1r1r1r1r1r1r1r1r1r1r1r1r1r
1y1y1y1y1y1y1y1y1y1y1y1y1y1y1y1y1y1y1y
1b1b1b1b1b1b1b1b1b1b1b1b1b1b1b1b1b1b1b
1p1p1p1p1p1p1p1p1p1p1p1p1p1p1p1p1p1p1p
1g1g1g1g1g1g1g1g1g1g1g1g1g1g1g1g1g1g1g
0333333333333333330
0000000000000000000
0000000000000000000
0000000000000000000
0000000000000000000
0000000000000000000
0000000000000000000
0000000000000000000
0000000000000000000
0000000000000000000
